%%%%%%%%%%
% @      %%%%%%%%%%%%%%%                
%        %             %
%        %             %
%%%%                   %
 %                     %
 %                     %
 %                     %
 %%%%%%%%%%%%%%%%%%%%%%%